che=chezmoi edit $*
chea=chezmoi edit --apply $*
chgaa=chezmoi git -- add --all $*
chgc=chezmoi git -- commit $*
chgp=chezmoi git -- push $*
chgst=chezmoi git -- status $*
chup=chezmoi update $*
chup=chezmoi update $*
g=git $*
gaa=git add --all $*
gb=git branch $*
gba=git branch --all $*
gbd=git branch --delete $*
gc!=git commit --verbose --amend $*
gc=git commit --verbose $*
gca!=git commit --verbose --all --amend $*
gca=git commit --verbose --all $*
gcb=git checkout -b $*
gcb=git checkout -b $*
gco=git checkout $*
gcor=git checkout --recurse-submodules $*
gl=git pull $*
glg=git log --stat $*
glog=git log --oneline --decorate --graph $*
gloga=git log --oneline --decorate --graph --all $*
glol=git log --graph $*
glola=git log --graph --all $*
gp=git push $*
gpf!=git push --force $*
gpf=git push --force-with-lease --force-if-includes $*
grb=git rebase $*
grba=git rebase --abort $*
grbc=git rebase --continue $*
grbi=git rebase --interactive $*
grh=git reset $*
grhh=git reset --hard $*
grhs=git reset --soft $*
gst=git status $*
gsta=git stash push $*
gstaa=git stash apply $*
gstc=git stash clear $*
gstd=git stash drop $*
gstl=git stash list $*
gstp=git stash pop $*
ls=dir $*
